1111111111111111111111
100MC000M00000000000E1
10MMMM0MM00MMMMM0MMMM1
1MM0CM0MMM000M0M0000M1
10M0MM00000MCMMMM00CM1
10M00MMM00MMMMMMMMMMM1
10MM000M0MM0000MCM0001
10M00M000MC0M0MM000M01
10M0000MMMMMM00MMMMM01
1P000M000000MM00000001
10MMMMM00MM00MMMMM0MM1
10000000MMMM00000000M1
1111111111111111111111
