1111111111111111
1000000000000001
10M0000C0MMMMM01
10M00M0000000M01
10MC0M0000000ME1
10MMMM000MMMMM01
10000M000M000001
10000M000M000001
10000M0M0MMMMM01
1P00000M000000C1
1111111111111111
