1111111111111
1001000000001
1000011111C01
1P0011C0E0001
1111111111111
