1111111111111111
1001000000000001
1000011111000001
1000111C00000101
10000000000001E1
1001101111110111
1001100000000001
1000000000000111
1P000000000000C1
1111111111111111
