1111111111111111
1000000000000001
1010000001111101
1010010000000101
1010010000C001E1
1011111001111101
1000010001000001
1000010001000001
1000010101111101
1P000000000000C1
1111111111111111
